R    1024     768
NO ./textures/bluestone.xpm
SO ./textures/colorstone.xpm
WE ./textures/greystone.xpm
EA ./textures/redbrick.xpm
S ./textures/barrel.xpm
F 220,100,0
C 225,30,20

        111111111111111111111111111111
        1000000000110000000000000000001
        101100000111000000200000111111
        1001000000000000W0000011
111111111011000001110000000000001
100000000011000001110111111111111
11110111111111011100000010001
11110111111111011101010010001
1100000011010101110000000001
1111111111111111111111111111
      
1111111111111111111111111111
1000200000000000222000100011      11111
10000000000000001101000010001      121
110000011101010111110111100111   11111
11110111 1110101 101111010001
11111111 1111111 111111111111
